date_est,OUT_CUST_UNITS,OUT_TO_UNITS,OUT_VR_UNITS,IN_CUST_UNITS,IN_PO_UNITS,IN_TO_UNITS,TTL_OUT_UNITS,TTL_IN_UNITS,TTL_ALL_UNITS
2016-01-01,256,0,0,19,0,0,256,19,275
2016-01-02,228,0,0,0,0,0,228,0,228
2016-01-03,208,0,0,0,0,0,208,0,208
2016-01-04,235,1,0,134,264,0,236,398,634
2016-01-05,362,24,0,112,338,0,386,450,836
2016-01-06,444,1,0,186,258,1,445,445,890
2016-01-07,381,100,1,95,249,86,482,430,912
2016-01-08,297,18,9,185,280,57,324,522,846
2016-01-09,257,55,0,11,0,0,312,11,323
2016-01-10,175,0,0,0,0,0,175,0,175
2016-01-11,203,34,0,150,287,0,237,437,674
2016-01-12,190,46,0,258,135,253,236,646,882
2016-01-13,231,219,12,244,13,0,462,257,719
2016-01-14,251,35,10,169,317,0,296,486,782
2016-01-15,215,27,0,94,290,0,242,384,626
2016-01-16,152,67,0,15,0,0,219,15,234
2016-01-17,132,0,0,0,0,0,132,0,132
2016-01-18,136,0,0,0,190,147,136,337,473
2016-01-19,178,45,0,296,391,1,223,688,911
2016-01-20,307,42,10,271,288,60,359,619,978
2016-01-21,259,69,1,196,183,130,329,509,838
2016-01-22,340,0,21,184,42,0,361,226,587
2016-01-23,246,62,0,29,0,0,308,29,337
2016-01-24,176,0,0,0,0,0,176,0,176
2016-01-25,219,16,0,97,166,37,235,300,535
2016-01-26,200,45,3,177,234,60,248,471,719
2016-01-27,203,6,11,129,369,0,220,498,718
2016-01-28,193,99,9,23,420,96,301,539,840
2016-01-29,176,148,0,152,288,0,324,440,764
2016-01-30,308,0,0,17,0,0,308,17,325
2016-01-31,146,0,0,0,0,0,146,0,146
2016-02-01,90,0,5,0,494,28,94,522,616
2016-02-02,123,121,0,454,160,48,244,662,906
2016-02-03,285,47,0,89,307,0,332,396,728
2016-02-04,167,139,0,124,246,140,306,510,816
2016-02-05,182,23,83,93,0,0,288,93,381
2016-02-06,97,35,0,51,0,0,132,51,183
2016-02-07,90,0,0,0,0,0,89,0,89
2016-02-08,117,34,3,58,480,0,154,538,692
2016-02-09,178,149,0,91,510,0,327,601,928
2016-02-10,402,126,10,209,502,49,538,760,1298
2016-02-11,306,121,0,119,533,0,427,652,1079
2016-02-12,229,76,20,165,261,17,325,443,768
2016-02-13,303,0,0,4,226,0,303,230,533
2016-02-14,156,0,0,0,0,0,156,0,156
2016-02-15,113,28,0,79,160,0,141,239,380
2016-02-16,160,70,1,98,366,53,231,517,748
2016-02-17,359,134,7,123,337,227,500,687,1187
2016-02-18,182,52,1,93,390,207,235,690,925
2016-02-19,245,37,0,152,283,2,282,437,719
2016-02-20,289,50,0,7,0,0,339,7,346
2016-02-21,126,0,0,0,0,0,126,0,126
2016-02-22,141,0,9,70,534,0,150,604,754
2016-02-23,344,9,0,182,215,50,353,447,800
2016-02-24,982,32,6,292,396,48,1020,736,1756
2016-02-25,440,93,0,204,257,2,533,463,996
2016-02-26,347,36,0,112,381,194,383,687,1070
2016-02-27,202,9,0,63,499,0,211,562,773
2016-02-28,221,0,0,0,0,0,221,0,221
2016-02-29,227,5,0,91,340,0,232,431,663
2016-03-01,460,4,2,120,260,48,466,428,894
2016-03-02,320,69,36,149,219,36,425,404,829
2016-03-03,355,88,2,150,324,48,445,522,967
2016-03-04,236,68,1,209,419,26,305,654,959
2016-03-05,180,5,0,106,0,0,185,106,291
2016-03-06,237,0,0,0,0,0,237,0,237
2016-03-07,106,3,0,124,374,41,109,539,648
2016-03-08,215,44,16,265,538,43,275,846,1121
2016-03-09,289,12,21,199,450,45,322,694,1016
2016-03-10,329,125,0,240,573,47,454,860,1314
2016-03-11,267,38,16,341,791,1,321,1133,1454
2016-03-12,329,2,0,10,0,0,331,10,341
2016-03-13,251,0,0,0,0,0,251,0,251
2016-03-14,189,4,0,112,659,108,193,879,1072
2016-03-15,274,108,0,390,702,4,382,1096,1478
2016-03-16,455,85,0,180,374,75,540,629,1169
2016-03-17,336,84,0,150,233,133,420,516,936
2016-03-18,234,25,0,272,399,27,259,698,957
2016-03-19,242,0,0,0,0,0,242,0,242
2016-03-20,107,0,0,0,0,0,107,0,107
2016-03-21,217,0,0,148,661,25,217,834,1051
2016-03-22,397,15,0,341,403,5,412,749,1161
2016-03-23,383,128,0,166,486,16,511,668,1179
2016-03-24,415,220,14,263,435,118,649,816,1465
2016-03-25,317,155,0,3,0,0,472,3,475
2016-03-26,160,0,1,0,0,0,161,0,161
2016-03-27,130,0,0,0,0,0,130,0,130
2016-03-28,206,0,0,140,181,66,206,387,593
2016-03-29,300,74,18,223,710,0,392,933,1325
2016-03-30,566,139,0,311,560,152,705,1023,1728
2016-03-31,367,111,6,153,379,0,484,532,1016
2016-04-01,309,3,40,127,75,33,352,235,587
2016-04-02,229,0,0,0,211,0,229,211,440
2016-04-03,133,0,0,0,0,0,133,0,133
2016-04-04,184,7,0,139,299,68,191,506,697
2016-04-05,409,16,0,417,407,108,425,932,1357
2016-04-06,392,91,0,244,415,42,483,701,1184
2016-04-07,242,106,0,233,730,160,348,1123,1471
2016-04-08,700,26,0,194,680,16,726,890,1616
2016-04-09,465,1,0,26,0,0,466,26,492
2016-04-10,185,0,0,0,0,0,185,0,185
2016-04-11,150,50,0,246,131,84,200,461,661
2016-04-12,188,67,9,592,264,21,264,877,1141
2016-04-13,293,121,0,255,274,10,414,539,953
2016-04-14,292,50,0,199,241,2,342,442,784
2016-04-15,432,38,13,298,458,59,483,815,1298
2016-04-16,189,83,1,0,0,0,273,0,273
2016-04-17,119,0,0,9,0,0,119,9,128
2016-04-18,160,102,0,1108,85,41,262,1234,1496
2016-04-19,207,27,3,196,321,0,237,517,754
2016-04-20,251,75,0,268,368,0,326,636,962
2016-04-21,393,92,6,162,146,1,491,309,800
2016-04-22,178,48,1,233,208,154,227,595,822
2016-04-23,134,0,2,4,0,0,136,4,140
2016-04-24,139,5,0,1,0,0,144,1,145
2016-04-25,149,105,0,302,145,25,254,472,726
2016-04-26,268,103,0,295,201,2,371,498,869
2016-04-27,262,115,22,592,179,207,399,978,1377
2016-04-28,258,35,26,484,231,155,319,870,1189
2016-04-29,243,16,0,259,152,0,259,411,670
2016-04-30,201,0,0,0,0,0,201,0,201
2016-05-01,111,77,0,0,0,0,188,0,188
2016-05-02,246,95,0,744,453,0,341,1197,1538
2016-05-03,200,17,2,11,265,1,219,277,496
2016-05-04,567,89,2,277,156,88,658,521,1179
2016-05-05,1330,94,12,303,185,76,1436,564,2000
2016-05-06,678,7,0,311,66,8,685,385,1070
2016-05-07,401,0,0,0,0,0,401,0,401
2016-05-08,225,0,0,0,0,0,225,0,225
2016-05-09,881,16,29,238,299,2,926,539,1465
2016-05-10,638,35,9,128,199,6,682,333,1015
2016-05-11,521,82,60,686,218,186,663,1090,1753
2016-05-12,258,26,61,143,404,29,345,576,921
2016-05-13,356,59,0,246,237,30,415,513,928
2016-05-14,170,0,3,3,0,0,173,3,176
2016-05-15,151,0,0,0,0,0,151,0,151
2016-05-16,205,17,0,175,514,140,222,829,1051
2016-05-17,293,41,2,650,352,0,336,1002,1338
2016-05-18,580,27,0,267,398,15,607,680,1287
2016-05-19,310,144,0,433,122,0,454,555,1009
2016-05-20,345,6,1,228,256,69,352,553,905
2016-05-21,199,1,0,302,0,0,200,302,502
2016-05-22,176,0,0,0,0,0,176,0,176
2016-05-23,252,5,0,405,586,107,257,1098,1355
2016-05-24,319,90,2,354,252,156,411,762,1173
2016-05-25,473,65,6,406,424,106,544,936,1480
2016-05-26,288,98,0,443,448,19,386,910,1296
2016-05-27,478,2,0,341,308,72,480,721,1201
2016-05-28,536,0,0,0,0,0,536,0,536
2016-05-29,273,0,0,0,0,0,273,0,273
2016-05-30,251,0,0,0,0,0,251,0,251
2016-05-31,373,30,0,148,493,93,403,734,1137
2016-06-01,524,127,20,788,780,77,671,1645,2316
2016-06-02,563,22,39,1203,314,1,624,1518,2142
2016-06-03,507,36,0,415,315,1,543,731,1274
2016-06-04,257,0,0,127,0,0,257,127,384
2016-06-05,197,0,0,0,0,0,197,0,197
2016-06-06,251,5,0,286,353,160,256,799,1055
2016-06-07,408,49,0,120,348,45,457,513,970
2016-06-08,380,55,1,348,382,6,436,736,1172
2016-06-09,344,34,0,173,532,66,378,771,1149
2016-06-10,491,13,0,197,581,42,504,820,1324
2016-06-11,355,0,0,12,0,0,355,12,367
2016-06-12,290,0,0,0,0,0,290,0,290
2016-06-13,403,40,28,253,979,5,471,1237,1708
2016-06-14,513,80,0,261,623,55,593,939,1532
2016-06-15,384,251,5,60,92,0,640,152,792
2016-06-16,755,264,0,315,263,24,1019,602,1621
2016-06-17,659,76,88,235,185,36,823,456,1279
2016-06-18,351,0,0,0,0,0,351,0,351
2016-06-19,266,0,0,0,0,0,266,0,266
2016-06-20,339,92,0,119,514,73,431,706,1137
2016-06-21,424,47,90,189,447,4,561,640,1201
2016-06-22,590,71,1,133,484,132,662,749,1411
2016-06-23,579,56,9,393,309,71,644,773,1417
2016-06-24,388,41,82,694,309,120,511,1123,1634
2016-06-25,356,2,0,5,0,0,358,5,363
2016-06-26,229,0,0,0,0,0,229,0,229
2016-06-27,248,5,0,126,453,107,253,686,939
2016-06-28,385,111,0,184,517,51,496,752,1248
2016-06-29,450,35,0,157,324,99,485,580,1065
2016-06-30,422,105,0,202,478,34,527,714,1241
2016-07-01,345,24,0,227,84,55,369,366,735
2016-07-02,334,0,0,76,453,0,334,529,863
2016-07-03,294,0,0,0,0,0,294,0,294
2016-07-04,210,28,0,4,0,0,238,4,242
2016-07-05,302,64,0,212,362,4,366,578,944
2016-07-06,282,37,36,219,388,171,355,778,1133
2016-07-07,362,53,0,201,295,2,415,498,913
2016-07-08,365,8,69,201,202,0,442,403,845
2016-07-09,259,0,0,5,0,0,259,5,264
2016-07-10,135,0,0,0,0,0,135,0,135
2016-07-11,203,23,8,99,334,2,234,435,669
2016-07-12,259,14,0,240,294,80,273,614,887
2016-07-13,300,89,0,197,424,132,389,753,1142
2016-07-14,227,60,0,155,289,59,287,503,790
2016-07-15,257,140,52,186,219,24,449,429,878
2016-07-16,256,110,0,0,0,0,366,0,366
2016-07-17,268,0,0,0,0,0,268,0,268
2016-07-18,219,221,0,163,550,6,440,719,1159
2016-07-19,301,27,16,116,534,8,344,658,1002
2016-07-20,318,52,0,169,712,65,370,946,1316
2016-07-21,482,151,18,83,356,0,651,439,1090
2016-07-22,371,66,0,85,410,14,437,509,946
2016-07-23,271,1,0,1,0,0,272,1,273
2016-07-24,155,0,0,0,0,0,155,0,155
2016-07-25,214,27,0,191,331,112,241,634,875
2016-07-26,302,107,12,187,354,51,421,592,1013
2016-07-27,379,89,0,113,370,141,468,624,1092
2016-07-28,729,15,0,124,901,2,744,1027,1771
2016-07-29,332,9,22,156,479,0,363,635,998
2016-07-30,392,2,0,4,0,0,394,4,398
2016-07-31,187,0,0,0,0,0,187,0,187
2016-08-01,284,26,0,83,389,39,310,511,821
2016-08-02,385,32,43,99,427,33,460,559,1019
2016-08-03,470,69,0,365,331,155,539,851,1390
2016-08-04,346,89,0,128,559,144,435,831,1266
2016-08-05,339,60,13,89,478,0,412,567,979
2016-08-06,226,9,2,15,0,0,237,15,252
2016-08-07,295,0,0,0,0,0,295,0,295
2016-08-08,264,111,10,122,496,1,385,619,1004
2016-08-09,344,65,5,119,374,79,414,572,986
2016-08-10,368,82,54,145,380,90,504,615,1119
2016-08-11,318,101,8,111,401,14,427,526,953
2016-08-12,214,188,12,126,404,66,414,596,1010
2016-08-13,146,0,0,0,415,0,146,415,561
2016-08-14,154,0,0,0,0,0,154,0,154
2016-08-15,231,8,4,98,618,4,243,720,963
2016-08-16,590,34,0,49,406,120,624,575,1199
2016-08-17,460,63,50,25,580,120,573,725,1298
2016-08-18,277,92,15,1,697,0,384,698,1082
2016-08-19,500,59,1,121,468,0,560,589,1149
2016-08-20,1072,3,0,94,1246,55,1075,1395,2470
2016-08-21,121,0,0,0,0,0,121,0,121
2016-08-22,306,36,0,95,684,0,342,779,1121
2016-08-23,234,11,3,186,842,38,248,1066,1314
2016-08-24,698,73,62,151,1006,89,833,1246,2079
2016-08-25,482,116,16,93,821,1,614,915,1529
2016-08-26,391,40,0,279,808,0,431,1087,1518
2016-08-27,362,0,0,5,0,0,362,5,367
2016-08-28,200,0,0,0,0,0,200,0,200
2016-08-29,144,9,0,47,608,5,153,660,813
2016-08-30,177,199,0,249,657,91,376,997,1373
2016-08-31,344,14,0,180,435,174,358,789,1147
2016-09-01,451,99,0,110,471,3,550,584,1134
2016-09-02,389,77,4,276,425,0,470,701,1171
2016-09-03,299,76,2,0,149,90,377,239,616
2016-09-04,126,0,0,0,0,0,126,0,126
2016-09-05,136,58,1,0,0,0,195,0,195
2016-09-06,154,73,0,203,459,0,227,662,889
2016-09-07,224,124,0,238,679,81,348,998,1346
2016-09-08,311,8,38,196,758,0,357,954,1311
2016-09-09,429,204,29,419,339,10,662,768,1430
2016-09-10,227,0,0,335,385,0,227,720,947
2016-09-11,166,0,0,0,0,0,166,0,166
2016-09-12,215,308,0,179,359,58,523,596,1119
2016-09-13,375,190,0,220,570,59,565,849,1414
2016-09-14,392,121,0,251,272,136,513,659,1172
2016-09-15,262,240,8,223,488,135,510,846,1356
2016-09-16,333,30,26,126,514,162,389,802,1191
2016-09-17,90,0,0,101,419,84,120,604,724
2016-09-18,253,0,0,0,0,0,253,0,253
2016-09-19,205,91,13,422,412,0,309,834,1143
2016-09-20,400,105,0,311,567,263,505,1141,1646
2016-09-21,361,66,24,448,211,160,451,819,1270
2016-09-22,220,143,3,128,363,196,366,687,1053
2016-09-23,473,21,10,380,436,37,504,853,1357
2016-09-24,328,25,1,2,4,0,354,6,360
2016-09-25,173,0,0,0,0,0,173,0,173
2016-09-26,199,18,1,277,801,0,218,1078,1296
2016-09-27,257,144,0,164,648,1,401,813,1214
2016-09-28,565,131,0,178,403,95,696,676,1372
2016-09-29,261,142,1,159,274,54,404,487,891
2016-09-30,197,8,0,220,278,123,205,621,826
2016-10-01,256,0,0,1,0,0,256,1,257
2016-10-02,127,0,0,0,0,0,127,0,127
2016-10-03,177,32,0,168,495,101,209,764,973
2016-10-04,309,101,0,86,233,138,410,457,867
2016-10-05,347,50,4,545,329,93,401,967,1368
2016-10-06,210,279,4,344,319,119,493,782,1275
2016-10-07,209,151,6,272,160,0,366,432,798
2016-10-08,164,7,17,119,0,0,188,119,307
2016-10-09,169,0,0,0,0,0,169,0,169
2016-10-10,142,100,61,208,184,71,303,463,766
2016-10-11,182,39,0,290,362,30,221,682,903
2016-10-12,198,34,0,323,109,128,232,560,792
2016-10-13,303,28,0,559,216,48,331,823,1154
2016-10-14,179,0,0,248,325,12,179,585,764
2016-10-15,222,19,0,1,0,0,241,1,242
2016-10-16,199,0,0,0,0,0,199,0,199
2016-10-17,239,28,6,169,236,54,273,459,732
2016-10-18,355,125,35,271,217,102,515,590,1105
2016-10-19,311,96,8,248,448,34,415,730,1145
2016-10-20,245,103,0,177,152,87,348,416,764
2016-10-21,513,58,20,176,270,26,591,472,1063
2016-10-22,169,8,2,4,0,0,179,4,183
2016-10-23,129,0,0,0,0,0,129,0,129
2016-10-24,122,91,11,147,586,26,224,759,983
2016-10-25,208,174,1,265,345,26,383,636,1019
2016-10-26,295,87,1,154,368,90,383,612,995
2016-10-27,372,130,4,662,716,133,506,1511,2017
2016-10-28,372,18,5,99,287,18,395,404,799
2016-10-29,195,1,0,224,301,2,196,527,723
2016-10-30,238,0,0,0,0,0,238,0,238
2016-10-31,206,18,1,160,609,0,225,769,994
2016-11-01,417,61,0,118,467,10,478,595,1073
2016-11-02,201,28,1,212,614,61,230,887,1117
2016-11-03,405,151,0,541,429,96,556,1066,1622
2016-11-04,303,26,7,191,542,89,336,822,1158
2016-11-05,205,0,1,0,0,0,206,0,206
2016-11-06,168,0,0,0,0,0,168,0,168
2016-11-07,200,8,0,128,247,137,208,512,720
2016-11-08,221,39,54,243,581,76,314,900,1214
2016-11-09,2207,93,44,129,455,133,2344,717,3061
2016-11-10,988,240,28,127,335,52,1256,514,1770
2016-11-11,587,17,71,317,334,3,675,654,1329
2016-11-12,385,41,0,329,417,0,426,746,1172
2016-11-13,527,0,0,30,0,0,527,30,557
2016-11-14,985,0,81,330,167,45,1066,542,1608
2016-11-15,716,40,0,533,195,43,756,771,1527
2016-11-16,512,121,18,219,282,63,651,564,1215
2016-11-17,561,110,16,215,370,9,687,594,1281
2016-11-18,347,27,31,255,441,0,405,696,1101
2016-11-19,495,52,10,419,583,10,557,1012,1569
2016-11-20,287,0,0,51,0,0,287,51,338
2016-11-21,446,16,112,270,422,10,574,702,1276
2016-11-22,588,200,15,316,773,0,803,1089,1892
2016-11-23,523,34,0,249,979,35,557,1263,1820
2016-11-24,592,3,0,339,301,18,595,658,1253
2016-11-25,640,217,40,128,384,55,897,567,1464
2016-11-26,480,0,68,460,642,41,548,1143,1691
2016-11-27,382,0,0,0,0,0,382,0,382
2016-11-28,539,64,25,210,565,4,628,779,1407
2016-11-29,717,249,71,396,563,81,1037,1040,2077
2016-11-30,591,211,92,586,995,40,894,1621,2515
2016-12-01,574,404,1,506,549,0,979,1055,2034
2016-12-02,622,67,41,761,696,6,730,1463,2193
2016-12-03,490,22,0,853,736,0,512,1589,2101
2016-12-04,547,0,0,226,240,127,547,593,1140
2016-12-05,440,186,0,238,449,122,626,809,1435
2016-12-06,513,34,1,398,578,25,548,1001,1549
2016-12-07,462,47,0,406,498,79,509,983,1492
2016-12-08,670,33,118,177,640,0,821,817,1638
2016-12-09,539,56,1,293,651,101,596,1045,1641
2016-12-10,498,167,0,193,24,0,665,217,882
2016-12-11,532,0,0,0,0,0,532,0,532
2016-12-12,610,299,0,107,329,22,909,458,1367
2016-12-13,562,70,0,426,1009,1,632,1436,2068
2016-12-14,728,51,95,424,498,282,874,1204,2078
2016-12-15,644,31,1,367,669,161,676,1197,1873
2016-12-16,721,146,150,423,975,0,1017,1398,2415
2016-12-17,903,132,0,347,0,0,1035,347,1382
2016-12-18,607,0,0,140,0,0,607,140,747
2016-12-19,462,65,30,117,408,56,557,581,1138
2016-12-20,540,60,131,327,755,0,731,1082,1813
2016-12-21,558,53,395,352,421,128,1006,901,1907
2016-12-22,592,77,1,283,335,191,670,809,1479
2016-12-23,568,79,72,279,543,110,719,932,1651
2016-12-24,811,0,0,245,0,0,811,245,1056
2016-12-25,699,0,0,0,0,0,699,0,699
2016-12-26,215,0,0,0,0,0,215,0,215
2016-12-27,262,0,0,49,423,34,262,506,768
2016-12-28,299,107,2,248,384,114,408,746,1154
2016-12-29,439,143,0,228,1027,0,582,1255,1837
2016-12-30,505,6,116,123,185,69,627,377,1004
2016-12-31,635,0,0,118,0,0,635,118,753
2017-01-01,175,0,0,22,0,0,175,22,197
2017-01-02,175,0,0,0,0,0,143,0,143
2017-01-03,285,6,0,127,574,138,291,839,1130
2017-01-04,438,91,2,237,527,195,531,959,1490
2017-01-05,747,85,0,126,1040,108,832,1274,2106
2017-01-06,507,30,0,198,1358,131,537,1687,2224
2017-01-07,708,89,0,267,0,0,797,267,1064
2017-01-08,489,0,0,39,0,0,489,39,528
2017-01-09,295,53,11,47,918,112,359,1077,1436
2017-01-10,568,22,174,202,1121,85,764,1408,2172
2017-01-11,759,210,17,264,459,136,986,859,1845
2017-01-12,641,10,9,240,598,80,660,918,1578
2017-01-13,534,2,13,60,0,0,549,60,609
2017-01-14,273,64,8,0,0,0,345,0,345
2017-01-15,243,0,0,0,0,0,243,0,243
2017-01-16,272,98,0,134,179,8,370,321,691
2017-01-17,291,265,0,217,456,18,556,691,1247
2017-01-18,569,97,30,209,284,84,696,577,1273
2017-01-19,531,165,4,231,344,121,700,696,1396
2017-01-20,470,26,0,180,368,59,496,607,1103
2017-01-21,416,19,0,37,0,0,435,37,472
2017-01-22,294,0,0,0,0,0,294,0,294
2017-01-23,212,9,0,259,603,52,221,914,1135
2017-01-24,394,100,79,366,324,27,573,717,1290
2017-01-25,469,184,8,678,179,112,661,969,1630
2017-01-26,290,45,0,281,325,5,335,611,946
2017-01-27,333,91,7,168,222,16,431,406,837
2017-01-28,278,11,26,119,0,0,315,119,434
2017-01-29,200,0,0,0,0,0,200,0,200
2017-01-30,224,20,0,164,257,94,244,515,759
2017-01-31,370,57,0,320,216,41,427,577,1004
2017-02-01,344,162,70,178,260,98,576,536,1112
2017-02-02,363,143,1,182,166,109,507,457,964
2017-02-03,399,35,5,310,468,61,439,839,1278
2017-02-04,175,0,0,164,0,0,120,164,284
2017-02-05,175,0,0,0,0,0,120,0,120
2017-02-06,642,102,0,198,219,139,744,556,1300
2017-02-07,372,92,6,301,382,5,470,688,1158
2017-02-08,411,223,310,279,370,40,944,689,1633
2017-02-09,402,55,72,319,187,0,529,506,1035
2017-02-10,366,258,4,42,408,55,628,505,1133
2017-02-11,202,42,3,109,0,0,247,109,356
2017-02-12,282,0,0,0,0,0,282,0,282
2017-02-13,311,48,41,96,660,0,400,756,1156
2017-02-14,176,239,3,439,423,32,418,894,1312
2017-02-15,505,27,0,549,490,91,532,1130,1662
2017-02-16,423,206,51,340,254,121,680,715,1395
2017-02-17,374,8,1,239,586,145,383,970,1353
2017-02-18,326,0,0,26,0,0,326,26,352
2017-02-19,330,0,0,0,0,0,330,0,330
2017-02-20,215,43,3,119,553,143,261,815,1076
2017-02-21,276,38,0,272,374,194,314,840,1154
2017-02-22,427,59,50,272,740,114,536,1126,1662
2017-02-23,449,77,0,188,585,136,526,909,1435
2017-02-24,775,94,0,199,636,63,869,898,1767
2017-02-25,996,23,13,120,641,6,1032,767,1799
2017-02-26,370,0,0,0,0,0,370,0,370
2017-02-27,291,213,3,84,688,10,507,782,1289
2017-02-28,280,22,0,159,523,90,302,772,1074
2017-03-01,414,9,0,267,347,28,423,642,1065
2017-03-02,357,103,3,251,517,42,463,810,1273
2017-03-03,323,21,0,286,516,10,344,812,1156
2017-03-04,388,1,0,8,678,0,389,686,1075
2017-03-05,351,0,0,0,0,0,351,0,351
2017-03-06,533,42,0,238,782,38,575,1058,1633
2017-03-07,363,41,25,290,532,60,429,882,1311
2017-03-08,721,95,34,178,429,82,850,689,1539
2017-03-09,420,86,0,282,426,134,506,842,1348
2017-03-10,539,37,0,530,544,2,576,1076,1652
2017-03-11,296,25,0,159,467,0,321,626,947
2017-03-12,438,0,0,0,0,0,438,0,438
2017-03-13,364,52,0,165,628,90,416,883,1299
2017-03-14,340,27,0,24,0,0,367,24,391
2017-03-15,288,88,38,124,346,223,414,693,1107
2017-03-16,204,172,36,43,800,73,412,916,1328
2017-03-17,334,133,0,337,472,116,467,925,1392
2017-03-18,234,48,0,82,489,19,282,590,872
2017-03-19,314,92,0,0,0,0,406,0,406
2017-03-20,507,21,0,285,645,0,528,930,1458
2017-03-21,519,13,23,579,617,23,555,1219,1774
2017-03-22,799,184,15,274,914,87,998,1275,2273
2017-03-23,932,240,44,278,704,151,1216,1133,2349
2017-03-24,595,174,0,212,837,44,769,1093,1862
2017-03-25,417,88,0,6,468,58,505,532,1037
2017-03-26,436,1,0,190,0,0,437,190,627
2017-03-27,446,76,11,192,647,119,533,958,1491
2017-03-28,401,94,8,364,499,50,503,913,1416
2017-03-29,621,94,0,318,1091,159,715,1568,2283
2017-03-30,582,248,18,391,790,85,848,1266,2114
2017-03-31,595,30,39,181,585,19,664,785,1449
2017-04-01,595,5,0,188,639,0,600,827,1427
2017-04-02,409,0,0,15,0,0,409,15,424
2017-04-03,523,90,12,209,819,93,625,1121,1746
2017-04-04,383,50,46,466,619,41,479,1126,1605
2017-04-05,600,83,1,315,390,129,684,834,1518
2017-04-06,348,87,13,132,580,98,448,810,1258
2017-04-07,525,82,50,635,494,116,657,1245,1902
2017-04-08,539,14,0,10,509,0,553,519,1072
2017-04-09,304,0,0,424,0,0,304,424,728
2017-04-10,408,77,0,147,458,42,485,647,1132
2017-04-11,433,54,20,208,551,173,507,932,1439
2017-04-12,496,101,0,773,378,87,597,1238,1835
2017-04-13,456,485,0,352,630,137,941,1119,2060
2017-04-14,358,31,12,2,0,0,401,2,403
2017-04-15,220,0,0,0,269,0,220,269,489
2017-04-16,179,77,0,0,0,0,256,0,256
2017-04-17,447,18,0,928,580,51,465,1559,2024
2017-04-18,632,399,0,514,422,125,1031,1061,2092
2017-04-19,618,99,0,1001,594,50,717,1645,2362
2017-04-20,454,111,0,1,638,149,565,788,1353
2017-04-21,383,62,10,1145,835,171,455,2151,2606
2017-04-22,495,25,0,762,0,0,520,762,1282
2017-04-23,593,0,0,0,0,0,593,0,593
2017-04-24,328,85,245,2,1106,85,658,1193,1851
2017-04-25,470,228,21,587,474,135,719,1196,1915
2017-04-26,405,66,32,793,339,103,503,1235,1738
2017-04-27,419,117,0,257,534,78,536,869,1405
2017-04-28,429,251,20,419,120,84,700,623,1323
2017-04-29,373,122,0,88,0,0,495,88,583
2017-04-30,305,0,0,0,0,0,305,0,305
2017-05-01,301,231,2,222,259,114,534,595,1129
2017-05-02,384,17,36,789,137,126,437,1052,1489
2017-05-03,429,6,2,225,178,192,437,595,1032
2017-05-04,3693,134,0,1493,188,39,3827,1720,5547
2017-05-05,1169,0,20,513,216,134,1189,863,2052
2017-05-06,706,27,0,468,0,0,733,468,1201
2017-05-07,567,0,0,14,0,0,567,14,581
2017-05-08,1857,128,31,67,266,181,2016,514,2530
2017-05-09,1030,60,10,394,399,57,1100,850,1950
2017-05-10,902,166,36,753,412,86,1104,1251,2355
2017-05-11,609,63,0,617,360,136,672,1113,1785
2017-05-12,482,118,0,364,444,4,600,812,1412
2017-05-13,442,5,0,22,0,12,447,34,481
2017-05-14,386,0,0,548,0,0,386,548,934
2017-05-15,608,44,2,188,199,60,654,447,1101
2017-05-16,722,109,19,711,422,45,850,1178,2028
2017-05-17,637,107,9,657,430,105,753,1192,1945
2017-05-18,564,114,4,479,508,108,682,1095,1777
2017-05-19,607,206,0,1787,368,244,813,2399,3212
2017-05-20,619,110,0,1325,0,0,729,1325,2054
2017-05-21,397,0,0,6,0,0,397,6,403
2017-05-22,475,94,82,651,711,195,651,1557,2208
2017-05-23,505,71,38,1783,627,111,614,2521,3135
2017-05-24,623,76,1,821,791,68,700,1680,2380
2017-05-25,630,28,0,1318,731,93,658,2142,2800
2017-05-26,913,154,1,906,882,58,1068,1846,2914
2017-05-27,881,27,0,37,390,2,908,429,1337
2017-05-28,567,0,0,360,0,0,567,360,927
2017-05-29,674,0,0,5,0,0,674,5,679
2017-05-30,571,109,2,326,627,41,682,994,1676
2017-05-31,549,626,5,1270,512,135,1180,1917,3097
2017-06-01,631,250,0,617,780,40,881,1437,2318
2017-06-02,701,7,0,636,473,9,708,1118,1826
2017-06-03,513,18,0,43,0,0,531,43,574
2017-06-04,465,87,0,315,0,0,552,315,867
2017-06-05,399,91,49,417,315,0,539,732,1271
2017-06-06,814,104,208,401,759,155,1126,1315,2441
2017-06-07,923,97,6,527,427,284,1026,1238,2264
2017-06-08,878,133,0,611,823,40,1011,1474,2485
2017-06-09,870,28,0,632,737,46,898,1415,2313
2017-06-10,623,59,0,79,0,0,682,79,761
2017-06-11,545,0,0,6,0,0,545,6,551
2017-06-12,521,84,0,78,315,93,605,486,1091
2017-06-13,665,116,0,856,346,72,781,1274,2055
2017-06-14,811,150,0,277,519,167,961,963,1924
2017-06-15,755,163,0,356,472,89,918,917,1835
2017-06-16,707,122,0,227,865,44,829,1136,1965
2017-06-17,520,59,0,8,764,0,579,772,1351
2017-06-18,755,0,0,177,0,0,755,177,932
2017-06-19,742,92,0,160,674,0,834,834,1668
2017-06-20,567,75,0,378,472,47,642,897,1539
2017-06-21,772,217,3,360,613,204,992,1177,2169
2017-06-22,740,189,0,464,512,74,929,1050,1979
2017-06-23,716,32,0,456,376,1,748,833,1581
2017-06-24,691,2,0,18,0,0,693,18,711
2017-06-25,471,0,0,38,0,0,471,38,509
2017-06-26,454,95,1,153,456,0,550,609,1159
2017-06-27,534,76,13,329,603,136,623,1068,1691
2017-06-28,882,88,1,307,550,256,971,1113,2084
2017-06-29,812,54,0,237,444,130,866,811,1677
2017-06-30,652,142,23,178,322,102,817,602,1419
2017-07-01,802,0,0,32,87,0,802,119,921
2017-07-02,774,0,0,0,0,0,774,0,774
2017-07-03,545,28,0,141,370,0,573,511,1084
2017-07-04,572,1,0,389,0,0,573,389,962
2017-07-05,489,283,8,212,539,40,780,791,1571
2017-07-06,340,147,0,256,847,72,487,1175,1662
2017-07-07,626,16,1,935,566,98,643,1599,2242
2017-07-08,587,0,0,33,0,0,587,33,620
2017-07-09,312,0,0,0,0,0,312,0,312
2017-07-10,424,23,25,644,500,74,472,1218,1690
2017-07-11,487,41,0,712,610,47,528,1369,1897
2017-07-12,529,296,21,267,597,58,846,922,1768
2017-07-13,529,102,0,202,513,33,631,748,1379
2017-07-14,732,355,0,138,753,257,1087,1148,2235
2017-07-15,345,50,0,89,0,0,395,89,484
2017-07-16,378,0,0,0,0,0,378,0,378
2017-07-17,286,6,22,55,474,21,314,550,864
2017-07-18,461,295,19,1683,508,41,775,2232,3007
2017-07-19,546,130,0,213,373,97,676,683,1359
2017-07-20,628,80,2,318,595,9,710,922,1632
2017-07-21,598,53,0,293,871,47,651,1211,1862
2017-07-22,511,0,0,87,0,0,511,87,598
2017-07-23,337,0,0,0,0,0,337,0,337
2017-07-24,363,144,0,177,572,150,507,899,1406
2017-07-25,529,168,73,172,551,65,770,788,1558
2017-07-26,507,131,52,161,443,36,690,640,1330
2017-07-27,667,60,1,490,468,61,728,1019,1747
2017-07-28,371,49,36,167,325,135,456,627,1083
2017-07-29,321,34,0,98,0,0,355,98,453
2017-07-30,313,0,0,0,0,0,313,0,313
2017-07-31,299,29,15,74,896,86,343,1056,1399
2017-08-01,434,62,18,288,614,68,514,970,1484
2017-08-02,471,262,25,199,476,20,758,695,1453
2017-08-03,518,115,20,287,573,181,653,1041,1694
2017-08-04,536,54,27,341,406,126,617,873,1490
2017-08-05,356,7,0,112,0,0,363,112,475
2017-08-06,298,0,0,0,0,0,298,0,298
2017-08-07,350,30,5,244,1211,139,385,1594,1979
2017-08-08,580,116,3,147,1608,63,699,1818,2517
2017-08-09,1024,201,0,537,1471,124,1225,2132,3357
2017-08-10,1372,339,26,213,1471,115,1737,1799,3536
2017-08-11,935,146,31,251,771,114,1112,1136,2248
2017-08-12,624,2,0,9,0,0,626,9,635
2017-08-13,519,0,0,0,0,0,519,0,519
2017-08-14,490,71,33,354,219,39,594,612,1206
2017-08-15,707,31,6,166,874,123,744,1163,1907
2017-08-16,707,92,6,217,544,116,805,877,1682
2017-08-17,620,248,0,507,1139,74,868,1720,2588
2017-08-18,711,109,96,281,844,19,916,1144,2060
2017-08-19,709,0,7,0,0,0,716,0,716
2017-08-20,315,0,0,0,0,0,315,0,315
2017-08-21,291,48,10,333,619,115,349,1067,1416
2017-08-22,416,113,0,274,957,53,529,1284,1813
2017-08-23,741,67,1,354,850,155,809,1359,2168
2017-08-24,575,52,20,287,668,20,647,975,1622
2017-08-25,697,143,0,333,532,38,840,903,1743
2017-08-26,442,20,0,0,0,0,462,0,462
2017-08-27,183,0,0,0,0,0,183,0,183
2017-08-28,311,34,9,153,496,125,354,774,1128
2017-08-29,444,84,19,140,472,79,547,691,1238
2017-08-30,452,186,0,210,607,50,638,867,1505
2017-08-31,541,146,33,200,556,165,720,921,1641
2017-09-01,949,43,16,88,537,0,1008,625,1633
2017-09-02,386,0,0,0,0,0,386,0,386
2017-09-03,245,5,0,0,0,0,250,0,250
2017-09-04,206,0,0,0,0,0,206,0,206
2017-09-05,290,286,1,321,464,79,577,864,1441
2017-09-06,382,118,20,329,593,143,520,1065,1585
2017-09-07,449,185,0,331,798,20,634,1149,1783
2017-09-08,607,52,50,628,249,0,709,877,1586
2017-09-09,608,37,0,488,0,0,645,488,1133
2017-09-10,214,5,0,0,858,0,219,858,1077
2017-09-11,454,143,0,301,430,137,597,868,1465
2017-09-12,526,86,0,786,338,240,612,1364,1976
2017-09-13,197,51,3,718,341,207,251,1266,1517
2017-09-14,175,179,5,743,691,102,354,1536,1890
2017-09-15,546,137,0,309,502,28,683,839,1522
2017-09-16,656,47,0,0,0,0,703,0,703
2017-09-17,223,0,0,0,0,0,223,0,223
2017-09-18,199,85,0,348,633,30,284,1011,1295
2017-09-19,343,80,34,376,380,102,457,858,1315
2017-09-20,344,193,8,380,456,147,545,983,1528
2017-09-21,382,76,17,528,670,131,475,1329,1804
2017-09-22,438,71,24,390,474,135,533,999,1532
2017-09-23,448,10,0,2,547,0,458,549,1007
2017-09-24,313,0,0,0,0,0,313,0,313
2017-09-25,286,16,6,314,515,56,308,885,1193
2017-09-26,373,165,33,475,531,66,571,1072,1643
2017-09-27,424,132,15,722,385,38,571,1145,1716
2017-09-28,536,92,0,337,328,77,628,742,1370
2017-09-29,384,96,72,378,410,66,552,854,1406
2017-09-30,268,0,0,0,0,0,268,0,268
2017-10-01,291,0,0,0,0,0,291,0,291
2017-10-02,225,116,31,195,245,18,372,458,830
2017-10-03,265,150,32,340,458,179,447,977,1424
2017-10-04,340,65,39,465,448,76,444,989,1433
2017-10-05,382,271,80,550,436,2,733,988,1721
2017-10-06,433,100,12,524,496,106,545,1126,1671
2017-10-07,527,0,0,0,0,0,527,0,527
2017-10-08,276,0,0,0,0,0,276,0,276
2017-10-09,282,106,0,422,666,100,388,1188,1576
2017-10-10,440,45,0,506,373,53,485,932,1417
2017-10-11,402,380,0,368,521,211,782,1100,1882
2017-10-12,368,232,6,196,407,114,606,717,1323
2017-10-13,410,145,11,259,383,170,566,812,1378
2017-10-14,182,21,1,2,0,0,204,2,206
2017-10-15,175,0,0,0,0,0,174,0,174
2017-10-16,271,100,14,361,473,54,385,888,1273
2017-10-17,564,252,49,298,546,148,865,992,1857
2017-10-18,508,91,12,497,439,80,611,1016,1627
2017-10-19,419,120,1,251,369,152,540,772,1312
2017-10-20,452,51,0,213,630,77,503,920,1423
2017-10-21,365,66,0,1,0,0,431,1,432
2017-10-22,205,0,0,0,0,0,205,0,205
2017-10-23,248,157,0,230,96,149,405,475,880
2017-10-24,266,104,3,252,463,158,373,873,1246
2017-10-25,436,82,10,285,220,60,528,565,1093
2017-10-26,389,149,49,379,540,127,587,1046,1633
2017-10-27,219,82,21,403,369,218,322,990,1312
2017-10-28,252,0,0,0,0,0,252,0,252
2017-10-29,194,0,0,0,0,0,194,0,194
2017-10-30,276,22,3,324,425,101,301,850,1151
2017-10-31,418,67,19,287,633,101,504,1021,1525
2017-11-01,306,29,33,270,413,35,368,718,1086
2017-11-02,304,317,0,721,331,50,621,1102,1723
2017-11-03,367,236,53,351,605,62,656,1018,1674
2017-11-04,344,2,7,0,0,0,353,0,353
2017-11-05,715,0,0,0,0,0,715,0,715
2017-11-06,1168,142,62,235,699,56,1372,990,2362
2017-11-07,487,118,61,461,535,186,666,1182,1848
2017-11-08,3846,82,50,388,478,192,3978,1058,5036
2017-11-09,924,191,18,331,546,141,1133,1018,2151
2017-11-10,718,51,259,230,798,106,1028,1134,2162
2017-11-11,699,1,4,221,0,0,704,221,925
2017-11-12,475,0,0,0,0,0,475,0,475
2017-11-13,1207,51,0,133,515,18,1258,666,1924
2017-11-14,887,359,0,336,376,147,1246,859,2105
2017-11-15,521,19,9,262,513,38,549,813,1362
2017-11-16,610,101,27,668,670,27,738,1365,2103
2017-11-17,700,42,29,168,519,205,771,892,1663
2017-11-18,499,19,204,23,343,51,722,417,1139
2017-11-19,450,0,0,0,0,0,450,0,450
2017-11-20,747,32,0,1215,856,1,779,2072,2851
2017-11-21,683,38,50,564,553,187,771,1304,2075
2017-11-22,608,60,16,951,468,63,684,1482,2166
2017-11-23,489,7,7,41,0,0,503,41,544
2017-11-24,553,31,63,619,523,71,647,1213,1860
2017-11-25,411,0,4,374,633,0,415,1007,1422
2017-11-26,678,0,0,13,0,0,678,13,691
2017-11-27,607,99,0,379,713,122,706,1214,1920
2017-11-28,510,202,24,913,808,15,736,1736,2472
2017-11-29,670,104,5,746,474,26,779,1246,2025
2017-11-30,554,122,11,1109,575,94,687,1778,2465
2017-12-01,584,102,87,1344,482,81,773,1907,2680
2017-12-02,561,61,5,922,348,50,627,1320,1947
2017-12-03,471,0,0,37,0,0,471,37,508
2017-12-04,561,30,58,157,553,5,649,715,1364
2017-12-05,497,78,62,1345,511,80,637,1936,2573
2017-12-06,567,61,0,1023,394,167,628,1584,2212
2017-12-07,832,167,0,739,566,90,999,1395,2394
2017-12-08,601,62,0,86,816,54,663,956,1619
2017-12-09,509,56,52,577,960,62,617,1599,2216
2017-12-10,1193,0,0,579,0,0,1193,579,1772
2017-12-11,850,218,33,0,608,0,1101,608,1709
2017-12-12,727,48,38,750,879,4,813,1633,2446
2017-12-13,696,519,0,507,602,86,1215,1195,2410
2017-12-14,1011,73,1,506,595,49,1085,1150,2235
2017-12-15,724,84,27,273,892,110,835,1275,2110
2017-12-16,752,23,23,92,708,46,798,846,1644
2017-12-17,1032,0,0,51,0,0,1032,51,1083
2017-12-18,894,46,134,110,781,15,1074,906,1980
2017-12-19,723,191,12,318,919,160,926,1397,2323
2017-12-20,578,93,0,370,747,142,671,1259,1930
2017-12-21,742,124,0,362,754,137,866,1253,2119
2017-12-22,570,0,0,179,810,140,570,1129,1699
2017-12-23,1298,0,0,63,883,63,1298,1009,2307
2017-12-24,963,0,0,0,0,0,963,0,963
2017-12-25,528,0,0,0,0,0,528,0,528
2017-12-26,259,30,3,364,733,125,292,1222,1514
2017-12-27,451,0,1,1144,1173,211,452,2528,2980
2017-12-28,654,55,0,604,1003,83,709,1690,2399
2017-12-29,837,26,11,773,927,3,874,1703,2577
2017-12-30,666,0,0,314,0,0,666,314,980
2017-12-31,381,0,0,0,0,0,381,0,381
2018-01-01,210,0,0,0,0,0,184,0,184
2018-01-02,210,26,0,201,890,1,234,1092,1326
2018-01-03,565,81,1,729,1604,57,647,2390,3037
2018-01-04,871,38,9,96,565,33,918,694,1612
2018-01-05,849,71,0,151,790,14,920,955,1875
2018-01-06,574,0,7,52,0,0,581,52,633
2018-01-07,491,0,0,0,0,0,491,0,491
2018-01-08,317,91,0,946,518,93,408,1557,1965
2018-01-09,649,70,1,479,337,144,720,960,1680
2018-01-10,538,357,16,668,205,48,911,921,1832
2018-01-11,547,91,1,174,79,24,639,277,916
2018-01-12,448,2,170,50,0,0,620,50,670
2018-01-13,321,0,1,1,0,0,322,1,323
2018-01-14,281,0,0,0,0,0,281,0,281
2018-01-15,340,0,22,1,409,45,362,455,817
2018-01-16,496,38,57,278,611,0,591,889,1480
2018-01-17,673,121,136,451,433,128,930,1012,1942
2018-01-18,552,147,44,458,377,99,743,934,1677
2018-01-19,515,22,0,512,1013,57,537,1582,2119
2018-01-20,573,24,0,819,0,0,597,819,1416
2018-01-21,534,0,0,97,0,0,534,97,631
2018-01-22,412,318,16,125,794,16,746,935,1681
2018-01-23,615,77,33,479,524,174,725,1177,1902
2018-01-24,525,66,1,509,502,88,592,1099,1691
2018-01-25,656,159,4,346,536,116,819,998,1817
2018-01-26,488,42,68,360,552,118,598,1030,1628
2018-01-27,460,0,16,117,0,0,476,117,593
2018-01-28,436,0,0,0,0,0,436,0,436
2018-01-29,409,64,0,343,425,51,473,819,1292
2018-01-30,396,124,148,303,377,161,668,841,1509
2018-01-31,602,117,86,325,763,199,805,1287,2092
2018-02-01,514,158,0,444,328,69,672,841,1513
2018-02-02,568,27,149,378,780,0,744,1158,1902
2018-02-03,498,0,0,52,0,0,498,52,550
2018-02-04,406,0,0,0,0,0,406,0,406
2018-02-05,373,23,9,190,557,18,405,765,1170
2018-02-06,504,108,94,238,448,139,706,825,1531
2018-02-07,587,78,6,249,620,80,671,949,1620
2018-02-08,588,47,0,744,629,93,635,1466,2101
2018-02-09,489,94,13,112,628,57,596,797,1393
2018-02-10,662,38,24,101,0,0,724,101,825
2018-02-11,581,0,0,0,0,0,581,0,581
2018-02-12,341,102,0,463,403,54,443,920,1363
2018-02-13,330,72,0,83,915,113,402,1111,1513
2018-02-14,590,82,40,179,493,112,712,784,1496
2018-02-15,743,420,0,418,525,242,1163,1185,2348
2018-02-16,747,116,0,245,637,37,863,919,1782
2018-02-17,405,33,0,144,646,0,438,790,1228
2018-02-18,606,19,0,0,0,0,625,0,625
2018-02-19,328,86,0,104,634,8,414,746,1160
2018-02-20,543,85,1,309,515,154,629,978,1607
2018-02-21,577,144,6,370,501,90,727,961,1688
2018-02-22,499,233,24,732,729,5,756,1466,2222
2018-02-23,453,43,0,192,764,82,496,1038,1534
2018-02-24,981,4,0,0,597,0,985,597,1582
2018-02-25,301,0,0,0,0,0,301,0,301
2018-02-26,375,18,0,565,448,46,393,1059,1452
2018-02-27,437,159,12,473,559,151,608,1183,1791
2018-02-28,545,211,0,280,448,29,756,757,1513
2018-03-01,446,37,13,310,945,87,496,1342,1838
2018-03-02,588,128,123,336,1582,101,839,2019,2858
2018-03-03,682,39,33,53,555,0,754,608,1362
2018-03-04,604,0,0,0,0,0,604,0,604
2018-03-05,531,217,1,216,485,157,749,858,1607
2018-03-06,343,178,69,349,564,109,590,1022,1612
2018-03-07,594,300,1,340,610,291,895,1241,2136
2018-03-08,450,40,0,227,563,120,490,910,1400
2018-03-09,566,6,0,229,393,112,572,734,1306
2018-03-10,250,2,0,69,762,0,252,831,1083
2018-03-11,554,0,0,0,0,0,554,0,554
2018-03-12,484,105,41,326,540,95,630,961,1591
2018-03-13,421,86,36,625,619,172,543,1416,1959
2018-03-14,586,104,38,739,1083,86,728,1908,2636
2018-03-15,721,200,0,773,1085,0,921,1858,2779
2018-03-16,797,181,3,338,968,143,981,1449,2430
2018-03-17,967,38,0,9,609,0,1005,618,1623
2018-03-18,509,0,0,0,0,0,509,0,509
2018-03-19,541,85,39,326,984,19,665,1329,1994
2018-03-20,553,202,0,557,1012,185,755,1754,2509
2018-03-21,792,236,56,719,844,61,1084,1624,2708
2018-03-22,877,130,96,148,1052,45,1103,1245,2348
2018-03-23,687,103,19,334,538,49,809,921,1730
2018-03-24,491,34,28,1,651,10,553,662,1215
2018-03-25,210,0,0,0,0,0,93,0,93
2018-03-26,1249,129,2,342,847,155,1380,1344,2724
2018-03-27,683,128,40,735,786,175,851,1696,2547
2018-03-28,536,344,3,1,1079,35,883,1115,1998
2018-03-29,413,129,16,1235,891,0,558,2126,2684
2018-03-30,609,103,38,56,0,0,750,56,806
2018-03-31,789,0,0,3,130,0,789,133,922
2018-04-01,298,0,0,0,0,0,298,0,298
2018-04-02,318,187,0,118,566,126,505,810,1315
2018-04-03,536,328,85,450,585,100,949,1135,2084
2018-04-04,718,281,0,657,571,173,999,1401,2400
2018-04-05,612,213,86,516,653,148,911,1317,2228
2018-04-06,738,132,16,647,414,110,886,1171,2057
2018-04-07,609,2,0,200,845,139,611,1184,1795
2018-04-08,528,0,0,0,0,0,528,0,528
2018-04-09,588,118,85,233,499,154,791,886,1677
2018-04-10,621,99,84,992,703,131,804,1826,2630
2018-04-11,645,441,9,820,581,135,1095,1536,2631
2018-04-12,892,418,75,706,563,113,1385,1382,2767
2018-04-13,994,69,5,589,760,90,1068,1439,2507
2018-04-14,997,29,0,5,639,194,1026,838,1864
2018-04-15,676,0,0,0,0,0,676,0,676
2018-04-16,792,32,0,354,556,38,824,948,1772
2018-04-17,642,314,22,478,522,112,978,1112,2090
2018-04-18,714,205,0,648,586,128,919,1362,2281
2018-04-19,555,193,44,368,547,142,792,1057,1849
2018-04-20,714,184,0,461,1330,117,898,1908,2806
2018-04-21,552,89,10,683,0,0,651,683,1334
2018-04-22,388,0,0,20,0,0,388,20,408
2018-04-23,417,37,10,284,726,111,464,1121,1585
2018-04-24,530,203,14,607,693,78,747,1378,2125
2018-04-25,634,143,28,546,1237,158,805,1941,2746
2018-04-26,1126,98,10,457,977,111,1234,1545,2779
2018-04-27,1684,106,38,792,672,157,1828,1621,3449
2018-04-28,488,25,24,822,0,0,537,822,1359
2018-04-29,407,0,0,66,0,0,407,66,473
2018-04-30,367,48,50,103,476,122,465,701,1166
2018-05-01,478,155,44,1095,722,120,677,1937,2614
2018-05-02,570,73,201,841,374,179,844,1394,2238
2018-05-03,572,310,0,500,339,48,882,887,1769
2018-05-04,562,108,6,202,535,129,676,866,1542
2018-05-05,378,9,7,4,0,0,394,4,398
2018-05-06,332,0,0,0,0,0,332,0,332
2018-05-07,266,0,7,213,610,59,273,882,1155
2018-05-08,3520,418,87,138,494,114,4025,746,4771
2018-05-09,904,187,46,1722,503,137,1137,2362,3499
2018-05-10,921,221,60,1341,739,128,1202,2208,3410
2018-05-11,1351,197,46,386,578,81,1594,1045,2639
2018-05-12,963,127,31,1101,435,0,1121,1536,2657
2018-05-13,640,0,0,43,0,0,640,43,683
2018-05-14,671,189,113,332,642,66,973,1040,2013
2018-05-15,1132,281,0,595,510,157,1413,1262,2675
2018-05-16,1512,288,41,1657,402,128,1841,2187,4028
2018-05-17,1039,208,92,961,612,121,1339,1694,3033
2018-05-18,913,181,2,409,899,101,1096,1409,2505
2018-05-19,812,63,0,553,321,0,875,874,1749
2018-05-20,643,1,0,194,0,0,644,194,838
2018-05-21,734,30,29,345,513,108,793,966,1759
2018-05-22,763,344,178,2112,529,83,1285,2724,4009
2018-05-23,786,100,1,1278,696,212,887,2186,3073
2018-05-24,812,297,12,1394,507,94,1121,1995,3116
2018-05-25,1348,32,25,283,729,111,1405,1123,2528
2018-05-26,1232,26,0,1648,544,0,1258,2192,3450
2018-05-27,1077,0,0,73,0,0,1077,73,1150
2018-05-28,967,0,0,0,0,0,967,0,967
2018-05-29,943,143,0,351,636,194,1086,1181,2267
2018-05-30,1057,196,1,931,289,172,1254,1392,2646
2018-05-31,1211,151,6,1158,1354,146,1368,2658,4026
2018-06-01,787,134,96,523,1055,99,1017,1677,2694
2018-06-02,903,17,0,584,919,0,920,1503,2423
2018-06-03,783,0,0,0,0,0,783,0,783
2018-06-04,762,80,64,503,394,127,906,1024,1930
2018-06-05,706,116,46,1038,613,102,868,1753,2621
2018-06-06,1049,49,0,726,731,176,1098,1633,2731
2018-06-07,794,140,0,488,712,82,934,1282,2216
2018-06-08,885,101,49,654,389,125,1035,1168,2203
2018-06-09,680,46,0,471,817,1,726,1289,2015
2018-06-10,862,0,0,25,0,0,862,25,887
2018-06-11,562,43,0,462,1043,112,605,1617,2222
2018-06-12,944,291,22,754,556,136,1257,1446,2703
2018-06-13,1171,253,5,715,668,139,1429,1522,2951
2018-06-14,904,242,0,493,919,91,1146,1503,2649
2018-06-15,826,237,17,546,760,60,1080,1366,2446
2018-06-16,866,10,0,888,876,0,876,1764,2640
2018-06-17,967,0,0,55,0,0,967,55,1022
2018-06-18,746,164,9,326,660,75,919,1061,1980
2018-06-19,659,154,1,921,980,48,814,1949,2763
2018-06-20,1009,263,2,670,942,102,1274,1714,2988
2018-06-21,1001,56,4,595,1102,103,1061,1800,2861
2018-06-22,869,87,1,520,619,174,957,1313,2270
2018-06-23,1065,34,0,969,986,0,1099,1955,3054
2018-06-24,686,0,0,0,0,0,686,0,686
2018-06-25,607,71,0,111,994,0,678,1105,1783
2018-06-26,507,164,1,295,912,177,672,1384,2056
2018-06-27,810,168,9,853,701,86,987,1640,2627
2018-06-28,709,127,0,139,347,0,836,486,1322
2018-06-29,825,22,14,15,1400,203,861,1618,2479
2018-06-30,1073,6,0,0,552,0,1079,552,1631
2018-07-01,1076,0,0,0,0,0,1076,0,1076
2018-07-02,621,25,0,141,451,0,646,592,1238
2018-07-03,630,161,0,188,503,22,791,713,1504
2018-07-04,798,7,0,0,0,0,805,0,805
2018-07-05,457,23,0,8,426,12,480,446,926
2018-07-06,424,99,1,533,796,18,524,1347,1871
2018-07-07,630,0,0,0,594,19,630,613,1243
2018-07-08,529,0,0,0,0,0,529,0,529
2018-07-09,407,184,0,45,7,0,591,52,643
2018-07-10,377,103,5,381,212,308,485,901,1386
2018-07-11,482,56,0,1112,612,169,538,1893,2431
2018-07-12,522,209,0,666,598,129,731,1393,2124
2018-07-13,709,6,0,633,894,81,715,1608,2323
2018-07-14,382,0,0,5,0,0,382,5,387
2018-07-15,509,0,0,0,0,0,509,0,509
2018-07-16,632,47,11,436,755,24,690,1215,1905
2018-07-17,406,144,17,246,627,203,567,1076,1643
2018-07-18,759,75,30,537,607,150,864,1294,2158
2018-07-19,620,65,0,340,894,21,685,1255,1940
2018-07-20,620,75,11,851,887,139,706,1877,2583
2018-07-21,630,15,0,6,0,0,645,6,651
2018-07-22,619,0,0,0,0,0,619,0,619
2018-07-23,406,161,0,404,962,49,567,1415,1982
2018-07-24,482,150,22,791,951,135,654,1877,2531
2018-07-25,626,186,1,329,934,93,813,1356,2169
2018-07-26,881,254,1,384,721,1,1136,1106,2242
2018-07-27,774,54,0,592,1041,68,828,1701,2529
2018-07-28,643,75,0,7,0,0,718,7,725
2018-07-29,504,0,0,0,0,0,504,0,504
2018-07-30,380,47,10,309,464,100,437,873,1310
2018-07-31,327,194,19,227,1015,170,540,1412,1952
2018-08-01,504,223,0,472,1069,115,727,1656,2383
2018-08-02,851,221,15,473,1024,143,1087,1640,2727
2018-08-03,1021,75,5,362,912,118,1101,1392,2493
2018-08-04,996,27,53,1,1740,0,1076,1741,2817
2018-08-05,709,0,0,0,0,0,709,0,709
2018-08-06,737,25,39,273,605,168,801,1046,1847
2018-08-07,397,79,29,291,1078,93,505,1462,1967
2018-08-08,578,164,0,238,695,175,742,1108,1850
2018-08-09,506,114,0,433,1237,24,620,1694,2314
2018-08-10,689,65,12,326,861,170,766,1357,2123
2018-08-11,576,0,0,0,0,0,576,0,576
2018-08-12,570,0,0,0,0,0,570,0,570
2018-08-13,457,204,2,265,702,116,663,1083,1746
2018-08-14,440,68,0,319,629,71,508,1019,1527
2018-08-15,556,267,49,283,1194,220,872,1697,2569
2018-08-16,492,178,5,267,806,42,675,1115,1790
2018-08-17,493,64,38,382,1073,146,595,1601,2196
2018-08-18,460,19,0,0,669,0,479,669,1148
2018-08-19,393,0,0,0,0,0,393,0,393
2018-08-20,315,81,18,276,1954,10,414,2240,2654
2018-08-21,399,148,21,205,641,83,568,929,1497
2018-08-22,859,248,69,254,522,153,1176,929,2105
2018-08-23,492,121,4,364,1149,111,617,1624,2241
2018-08-24,411,71,10,225,878,74,492,1177,1669
2018-08-25,384,79,0,487,0,0,463,487,950
2018-08-26,364,0,0,0,0,0,364,0,364
2018-08-27,213,75,15,188,1110,124,303,1422,1725
2018-08-28,330,151,51,322,700,92,532,1114,1646
2018-08-29,714,231,56,396,814,173,1001,1383,2384
2018-08-30,388,248,45,309,552,110,681,971,1652
2018-08-31,438,287,0,282,438,87,725,807,1532
2018-09-01,359,22,0,10,521,97,381,628,1009
2018-09-02,422,0,0,0,0,0,422,0,422
2018-09-03,334,22,0,2,0,0,356,2,358
2018-09-04,262,175,0,580,1017,40,437,1637,2074
2018-09-05,491,191,44,406,883,114,726,1403,2129
2018-09-06,667,196,2,409,887,58,865,1354,2219
2018-09-07,1422,339,0,216,1072,103,1761,1391,3152
2018-09-08,673,174,0,212,1019,1,847,1232,2079
2018-09-09,610,0,0,0,0,0,610,0,610
2018-09-10,469,25,0,365,780,155,494,1300,1794
2018-09-11,498,365,26,585,1030,176,889,1791,2680
2018-09-12,595,158,0,393,1908,177,753,2478,3231
2018-09-13,873,388,0,260,1104,0,1261,1364,2625
2018-09-14,690,43,73,389,1433,60,806,1882,2688
2018-09-15,661,25,0,0,707,0,686,707,1393
2018-09-16,478,0,0,0,0,0,478,0,478
2018-09-17,502,40,1,572,1083,51,543,1706,2249
2018-09-18,375,430,4,451,539,80,809,1070,1879
2018-09-19,777,507,0,625,1007,245,1284,1877,3161
2018-09-20,630,230,4,409,911,183,864,1503,2367
2018-09-21,299,116,1,491,1026,259,416,1776,2192
2018-09-22,210,12,0,4,400,0,132,404,536
2018-09-23,210,0,0,0,0,0,120,0,120
2018-09-24,1024,36,8,344,718,86,1068,1148,2216
2018-09-25,950,135,0,460,657,80,1085,1197,2282
2018-09-26,453,88,0,347,1083,0,541,1430,1971
2018-09-27,511,191,1,567,959,275,703,1801,2504
2018-09-28,476,86,40,463,1866,36,602,2365,2967
2018-09-29,667,83,0,3,0,0,750,3,753
2018-09-30,775,0,0,0,0,0,775,0,775
2018-10-01,347,311,0,348,767,254,658,1369,2027
2018-10-02,388,62,1,319,753,247,451,1319,1770
2018-10-03,443,127,0,425,1185,210,570,1820,2390
2018-10-04,431,169,3,393,1186,138,603,1717,2320
2018-10-05,464,74,30,255,893,137,568,1285,1853
2018-10-06,606,32,0,279,0,0,638,279,917
2018-10-07,399,10,0,0,0,0,409,0,409
2018-10-08,210,0,0,471,514,85,142,1070,1212
2018-10-09,376,332,140,132,570,75,848,777,1625
2018-10-10,470,165,41,504,1029,88,676,1621,2297
2018-10-11,609,281,17,276,878,119,907,1273,2180
2018-10-12,706,159,0,279,914,84,865,1277,2142
2018-10-13,491,94,0,4,0,0,585,4,589
2018-10-14,396,0,0,0,0,0,396,0,396
2018-10-15,253,146,0,962,613,101,399,1676,2075
2018-10-16,372,109,0,692,1108,194,481,1994,2475
2018-10-17,532,130,0,625,766,178,662,1569,2231
2018-10-18,607,283,1,410,659,36,891,1105,1996
2018-10-19,575,141,78,724,769,173,794,1666,2460
2018-10-20,392,81,0,1,0,0,473,1,474
2018-10-21,313,0,0,0,0,0,313,0,313
2018-10-22,323,278,0,476,522,62,601,1060,1661
2018-10-23,384,134,1,384,482,323,519,1189,1708
2018-10-24,504,102,1,454,680,329,607,1463,2070
2018-10-25,527,371,35,402,872,162,933,1436,2369
2018-10-26,465,208,0,477,770,425,673,1672,2345
2018-10-27,342,62,0,3,0,0,404,3,407
2018-10-28,363,0,0,0,0,0,363,0,363
2018-10-29,322,41,0,581,915,151,363,1647,2010
2018-10-30,343,358,91,334,566,327,792,1227,2019
2018-10-31,438,140,3,337,541,214,581,1092,1673
2018-11-01,452,131,3,568,930,174,586,1672,2258
2018-11-02,487,163,33,437,1316,123,683,1876,2559
2018-11-03,430,3,7,0,0,0,440,0,440
2018-11-04,505,0,0,0,85,0,505,85,590
2018-11-05,344,89,0,311,458,201,433,970,1403
2018-11-06,464,192,9,271,830,147,665,1248,1913
2018-11-07,443,126,37,192,535,91,606,818,1424
2018-11-08,453,152,11,456,515,72,616,1043,1659
2018-11-09,374,165,102,343,394,178,641,915,1556
2018-11-10,388,9,15,442,0,0,412,442,854
2018-11-11,377,0,0,0,88,0,377,88,465
2018-11-12,2896,106,0,721,366,142,3002,1229,4231
2018-11-13,1072,48,12,255,389,107,1132,751,1883
2018-11-14,758,104,79,324,283,247,941,854,1795
2018-11-15,601,48,22,402,456,143,671,1001,1672
2018-11-16,510,101,93,436,449,135,704,1020,1724
2018-11-17,464,333,60,48,0,0,857,48,905
2018-11-18,349,0,0,0,0,0,349,0,349
2018-11-19,1418,297,148,152,942,29,1863,1123,2986
2018-11-20,1238,243,154,751,1240,171,1635,2162,3797
2018-11-21,1000,78,57,864,1338,33,1135,2235,3370
2018-11-22,878,61,0,20,869,0,939,889,1828
2018-11-23,1077,33,33,370,1509,51,1143,1930,3073
2018-11-24,1218,0,0,467,290,0,1218,757,1975
2018-11-25,1067,0,0,0,845,0,1067,845,1912
2018-11-26,1043,53,11,362,1399,130,1107,1891,2998
2018-11-27,1208,296,9,388,832,78,1513,1298,2811
2018-11-28,1185,278,43,1079,725,35,1506,1839,3345
2018-11-29,1170,175,137,615,1318,82,1482,2015,3497
2018-11-30,975,155,79,908,1375,90,1209,2373,3582
2018-12-01,909,35,5,1506,778,127,949,2411,3360
2018-12-02,908,0,0,899,635,0,908,1534,2442
2018-12-03,852,66,21,395,499,80,939,974,1913
2018-12-04,898,162,83,692,1399,29,1143,2120,3263
2018-12-05,993,74,36,644,1060,70,1103,1774,2877
2018-12-06,1025,169,49,1209,919,49,1243,2177,3420
2018-12-07,947,200,0,1688,962,49,1147,2699,3846
2018-12-08,893,98,0,535,0,0,991,535,1526
2018-12-09,883,0,0,301,305,0,883,606,1489
2018-12-10,858,74,2,765,957,5,934,1727,2661
2018-12-11,983,156,44,780,550,128,1183,1458,2641
2018-12-12,976,54,8,791,1137,142,1038,2070,3108
2018-12-13,967,361,4,642,1020,40,1332,1702,3034
2018-12-14,1004,473,8,333,1371,48,1485,1752,3237
2018-12-15,826,170,1,46,0,0,997,46,1043
2018-12-16,779,0,0,1660,0,0,779,1660,2439
2018-12-17,689,28,48,443,920,73,765,1436,2201
2018-12-18,800,158,62,1104,891,108,1020,2103,3123
2018-12-19,1416,56,1,787,1394,107,1473,2288,3761
2018-12-20,1046,50,3,1080,1485,126,1099,2691,3790
2018-12-21,1120,37,207,1245,1065,57,1364,2367,3731
2018-12-22,1044,23,0,959,0,0,1067,959,2026
2018-12-23,724,33,0,306,334,0,757,640,1397
2018-12-24,353,120,0,449,372,0,473,821,1294
2018-12-25,678,0,0,137,0,0,678,137,815
2018-12-26,992,10,0,244,1011,99,1002,1354,2356
2018-12-27,899,58,25,530,900,104,982,1534,2516
2018-12-28,1083,45,17,978,1087,138,1145,2203,3348
2018-12-29,969,0,2,181,0,0,971,181,1152
2018-12-30,742,0,0,1,0,0,742,1,743
2018-12-31,584,40,0,514,454,0,624,968,1592
2019-01-01,460,0,0,122,0,0,460,122,582
2019-01-02,604,51,32,924,1024,101,687,2049,2736
2019-01-03,645,91,213,526,936,183,949,1645,2594
2019-01-04,675,54,103,420,1211,375,832,2006,2838
2019-01-05,766,80,52,134,0,0,898,134,1032
2019-01-06,558,0,0,0,0,0,558,0,558
2019-01-07,597,81,0,236,1348,56,678,1640,2318
2019-01-08,892,329,55,703,1053,34,1276,1790,3066
2019-01-09,1763,335,8,724,1321,117,2106,2162,4268
2019-01-10,1152,102,67,399,958,84,1321,1441,2762
2019-01-11,1123,152,55,715,1218,53,1330,1986,3316
2019-01-12,889,184,0,257,0,0,1073,257,1330
2019-01-13,951,0,0,41,223,0,951,264,1215
2019-01-14,731,91,21,51,1064,55,843,1170,2013
2019-01-15,770,266,89,1102,1083,137,1125,2322,3447
2019-01-16,975,363,12,784,1080,159,1350,2023,3373
2019-01-17,867,255,79,456,1058,89,1201,1603,2804
2019-01-18,1166,105,4,584,1046,346,1275,1976,3251
2019-01-19,937,37,0,311,0,0,974,311,1285
2019-01-20,982,0,0,0,0,0,982,0,982
2019-01-21,582,64,0,109,574,32,646,715,1361
2019-01-22,543,121,39,253,908,96,703,1257,1960
2019-01-23,682,222,88,417,597,82,992,1096,2088
2019-01-24,911,335,0,293,809,235,1246,1337,2583
2019-01-25,443,238,18,665,1149,153,699,1967,2666
2019-01-26,300,0,0,227,0,0,180,227,407
2019-01-27,993,23,0,32,0,0,1016,32,1048
2019-01-28,675,43,0,44,540,205,718,789,1507
2019-01-29,694,304,76,605,1003,12,1074,1620,2694
2019-01-30,519,155,86,281,1523,104,760,1908,2668
2019-01-31,532,202,27,16,1631,69,761,1716,2477
2019-02-01,530,56,5,568,1973,28,591,2569,3160
2019-02-02,411,213,0,0,0,0,624,0,624
2019-02-03,305,0,0,303,0,0,305,303,608
2019-02-04,1146,104,0,3,1937,94,1250,2034,3284
2019-02-05,518,375,0,624,1738,108,893,2470,3363
2019-02-06,632,332,0,512,1854,175,964,2541,3505
2019-02-07,609,198,26,577,2316,136,833,3029,3862
2019-02-08,758,250,25,774,2198,105,1033,3077,4110
2019-02-09,841,115,0,146,0,0,956,146,1102
2019-02-10,735,0,0,0,0,0,735,0,735
2019-02-11,455,148,0,375,2376,35,603,2786,3389
2019-02-12,574,304,370,414,1140,12,1248,1566,2814
2019-02-13,987,107,84,336,1010,66,1178,1412,2590
2019-02-14,639,215,0,332,470,134,854,936,1790
2019-02-15,536,236,27,566,960,34,799,1560,2359
2019-02-16,383,77,0,123,0,0,460,123,583
2019-02-17,583,0,0,81,1204,24,583,1309,1892
2019-02-18,513,77,44,90,938,32,634,1060,1694
2019-02-19,730,190,2,212,1198,22,922,1432,2354
2019-02-20,563,173,13,178,1306,133,749,1617,2366
2019-02-21,1253,224,56,140,982,105,1533,1227,2760
2019-02-22,2039,53,35,307,1064,73,2127,1444,3571
2019-02-23,743,22,0,65,0,0,765,65,830
2019-02-24,1250,0,0,126,562,40,1250,728,1978
2019-02-25,502,145,14,264,1636,42,661,1942,2603
2019-02-26,446,281,13,308,1393,42,740,1743,2483
2019-02-27,454,241,26,307,735,2,721,1044,1765
2019-02-28,1194,66,1,836,633,32,1261,1501,2762
2019-03-01,512,431,20,336,1027,50,963,1413,2376
2019-03-02,471,10,0,275,0,0,481,275,756
2019-03-03,521,5,0,178,531,4,526,713,1239
2019-03-04,405,120,16,1604,1084,34,541,2722,3263
2019-03-05,519,72,2,57,1422,147,593,1626,2219
2019-03-06,813,121,19,277,1040,0,953,1317,2270
2019-03-07,823,140,52,189,1274,118,1015,1581,2596
2019-03-08,758,55,21,229,1512,129,834,1870,2704
2019-03-09,616,6,3,46,0,0,625,46,671
2019-03-10,416,0,0,161,363,4,416,528,944
2019-03-11,862,182,2,277,1035,55,1046,1367,2413
2019-03-12,505,124,14,793,970,51,643,1814,2457
2019-03-13,725,239,0,416,1125,75,964,1616,2580
2019-03-14,721,112,0,529,629,202,833,1360,2193
2019-03-15,704,79,3,493,529,143,786,1165,1951
2019-03-16,564,38,0,135,0,0,602,135,737
2019-03-17,304,31,0,293,276,12,335,581,916
2019-03-18,553,83,174,933,799,6,810,1738,2548
2019-03-19,426,162,8,1132,452,354,596,1938,2534
2019-03-20,649,165,14,329,404,118,828,851,1679
2019-03-21,543,105,29,464,838,81,677,1383,2060
2019-03-22,602,117,10,652,778,12,729,1442,2171
2019-03-23,352,0,0,155,690,51,352,896,1248
2019-03-24,483,8,0,248,396,4,491,648,1139
2019-03-25,385,25,0,350,714,47,410,1111,1521
2019-03-26,425,208,15,614,629,52,648,1295,1943
2019-03-27,984,242,0,416,833,56,1226,1305,2531
2019-03-28,640,150,13,329,1033,300,803,1662,2465
2019-03-29,689,177,0,433,827,113,866,1373,2239
2019-03-30,665,53,0,2,0,0,718,2,720
2019-03-31,301,0,0,100,709,24,301,833,1134
2019-04-01,518,80,0,374,1635,190,598,2199,2797
2019-04-02,710,131,0,571,989,399,841,1959,2800
2019-04-03,1018,164,33,475,1089,265,1215,1829,3044
2019-04-04,810,253,23,505,1479,133,1086,2117,3203
2019-04-05,822,134,20,545,1967,72,976,2584,3560
2019-04-06,888,32,25,43,0,0,945,43,988
2019-04-07,415,9,0,3,0,0,424,3,427
2019-04-08,717,50,115,863,1714,89,882,2666,3548
2019-04-09,1310,95,0,261,1586,14,1405,1861,3266
2019-04-10,1023,161,0,320,1435,96,1184,1851,3035
2019-04-11,743,169,6,415,1330,89,918,1834,2752
2019-04-12,1015,458,146,362,1201,6,1619,1569,3188
2019-04-13,871,11,5,125,0,0,887,125,1012
2019-04-14,868,10,0,6,0,0,878,6,884
2019-04-15,580,170,0,414,1733,32,750,2179,2929
2019-04-16,550,94,22,2021,1606,23,666,3650,4316
2019-04-17,976,148,0,471,1623,26,1124,2120,3244
2019-04-18,1261,55,31,312,1487,258,1347,2057,3404
2019-04-19,763,195,47,980,855,209,1005,2044,3049
2019-04-20,1037,77,0,345,59,14,1114,418,1532
2019-04-21,530,0,0,8,0,0,530,8,538
2019-04-22,598,81,4,386,820,185,683,1391,2074
2019-04-23,646,223,3,633,845,115,872,1593,2465
2019-04-24,1300,269,14,888,353,158,1583,1399,2982
2019-04-25,786,212,4,890,1014,87,1002,1991,2993
2019-04-26,632,63,0,810,570,30,695,1410,2105
2019-04-27,557,0,0,29,0,0,557,29,586
2019-04-28,454,0,0,4,0,0,454,4,458
2019-04-29,4624,25,7,604,776,186,4656,1566,6222
2019-04-30,1998,87,160,800,676,255,2245,1731,3976
2019-05-01,1297,157,105,948,950,72,1559,1970,3529
2019-05-02,1111,103,22,776,588,262,1236,1626,2862
2019-05-03,1169,192,52,442,1000,128,1413,1570,2983
2019-05-04,1592,6,0,445,2,1,1598,448,2046
2019-05-05,964,0,0,1,0,0,964,1,965
2019-05-06,860,8,5,838,739,31,873,1608,2481
2019-05-07,838,151,0,768,1190,152,989,2110,3099
2019-05-08,1017,141,1,1637,1069,45,1159,2751,3910
2019-05-09,1075,25,171,1020,851,58,1271,1929,3200
2019-05-10,910,45,374,1626,956,79,1329,2661,3990
2019-05-11,786,4,0,711,0,0,790,711,1501
2019-05-12,400,0,0,23,0,0,400,23,423
2019-05-13,473,0,0,709,1043,12,473,1764,2237
2019-05-14,1244,185,104,1978,895,13,1533,2886,4419
2019-05-15,983,196,45,2159,1027,7,1224,3193,4417
2019-05-16,911,5,0,2506,904,7,916,3417,4333
2019-05-17,2112,159,661,2254,470,11,2932,2735,5667
2019-05-18,3057,29,43,388,0,0,3129,388,3517
2019-05-19,1838,0,0,14,0,0,1838,14,1852
2019-05-20,1791,290,0,960,976,54,2081,1990,4071
2019-05-21,1355,171,5,1790,454,133,1531,2377,3908
2019-05-22,2278,153,1,1568,1253,69,2432,2890,5322
2019-05-23,1740,83,78,2797,1524,148,1901,4469,6370
2019-05-24,1555,123,30,1341,1353,85,1708,2779,4487
2019-05-25,1256,45,0,304,0,0,1301,304,1605
2019-05-26,1276,0,0,6,0,0,1276,6,1282
2019-05-27,1128,0,0,1,0,0,1128,1,1129
2019-05-28,1073,84,26,1170,1460,51,1183,2681,3864
2019-05-29,1081,105,28,2128,1640,68,1214,3836,5050
2019-05-30,1139,42,28,1461,1445,102,1209,3008,4217
2019-05-31,1480,247,17,1873,926,188,1744,2987,4731
2019-06-01,1360,0,0,266,0,0,1360,266,1626
2019-06-02,1158,0,0,133,0,0,1158,133,1291
2019-06-03,2055,54,0,418,1313,65,2109,1796,3905
2019-06-04,1709,25,1,2467,1459,145,1735,4071,5806
2019-06-05,1868,51,0,1694,861,78,1919,2633,4552
2019-06-06,1750,198,15,1680,924,66,1963,2670,4633
2019-06-07,1569,17,14,1124,558,83,1600,1765,3365
2019-06-08,1147,71,0,744,0,0,1218,744,1962
2019-06-09,1587,0,0,5,0,0,1587,5,1592
2019-06-10,1042,36,0,705,1171,127,1078,2003,3081
2019-06-11,1272,147,1,1719,1182,141,1420,3042,4462
2019-06-12,1317,132,0,1455,1054,71,1449,2580,4029
2019-06-13,1350,138,40,2106,977,81,1528,3164,4692
2019-06-14,1601,189,0,3017,1024,57,1790,4098,5888
2019-06-15,1271,0,0,1618,0,0,1271,1618,2889
2019-06-16,1242,0,0,22,0,0,1242,22,1264
2019-06-17,1017,106,0,1157,1727,2,1123,2886,4009
2019-06-18,2418,121,5,1764,1698,32,2544,3494,6038
2019-06-19,2430,145,2,1793,837,38,2577,2668,5245
2019-06-20,1992,132,10,773,0,0,2134,773,2907
2019-06-21,2057,68,0,82,1,0,2125,83,2208
2019-06-22,1591,16,0,0,0,0,1607,0,1607
2019-06-23,1213,0,0,0,0,0,1213,0,1213
2019-06-24,1506,28,0,0,0,0,1534,0,1534
2019-06-25,1517,40,38,3,12,0,1595,15,1610
2019-06-26,1365,56,24,491,906,40,1445,1437,2882
2019-06-27,1047,5,0,1551,45,11,1052,1607,2659
2019-06-28,1147,131,38,214,0,0,1316,214,1530
2019-06-29,1268,16,51,65,0,0,1335,65,1400
2019-06-30,1300,0,0,64,0,0,1300,64,1364
2019-07-01,921,30,0,474,1427,166,951,2067,3018
2019-07-02,933,82,3,2586,1109,10,1018,3705,4723
2019-07-03,1173,78,13,1411,1407,15,1264,2833,4097
2019-07-04,1326,18,0,2642,853,35,1344,3530,4874
2019-07-05,1422,0,0,1072,1057,18,1422,2147,3569
2019-07-06,1313,0,0,877,0,1,1313,878,2191
2019-07-07,1147,0,0,280,517,108,1147,905,2052
2019-07-08,979,98,0,508,991,111,1077,1610,2687
2019-07-09,1210,244,28,2022,844,188,1482,3054,4536
2019-07-10,1265,222,67,1519,787,179,1554,2485,4039
2019-07-11,1505,26,52,611,1151,53,1583,1815,3398
2019-07-12,1548,60,41,1144,1179,67,1649,2390,4039
2019-07-13,1027,28,0,439,658,18,1055,1115,2170
2019-07-14,1018,0,0,0,727,15,1018,742,1760
2019-07-15,1156,163,0,1,1024,106,1319,1131,2450
2019-07-16,1693,240,48,519,1080,80,1981,1679,3660
2019-07-17,1707,133,0,1451,1110,46,1840,2607,4447
2019-07-18,1254,44,1,782,1591,22,1299,2395,3694
2019-07-19,1299,208,4,1287,1109,58,1511,2454,3965
2019-07-20,1673,2,0,961,1045,13,1675,2019,3694
2019-07-21,1079,0,0,339,620,33,1079,992,2071
2019-07-22,955,70,8,494,1474,60,1033,2028,3061
2019-07-23,1183,311,0,583,958,26,1494,1567,3061
2019-07-24,2279,35,26,817,992,49,2340,1858,4198
2019-07-25,2172,334,2,697,1490,46,2508,2233,4741
2019-07-26,1636,218,5,757,881,31,1859,1669,3528
